{
    "width": 128,
    "height": 128,
    "layers": [
        {
            "name": "1",
            "data": [[4, 4, 4, 4, 4, 4, 4, 4, 4, 4], 
                    [4, 4, 4, 4, 4, 4, 4, 4, 4, 4], 
                    [4, 4, 4, 4, 4, 4, 4, 4, 4, 4], 
                    [4, 4, 4, 4, 4, 4, 4, 4, 4, 4], 
                    [4, 4, 4, 4, 4, 4, 4, 4, 4, 4]]
        },
        {
            "name": "2",
            "data": [[0, 0, 0, 0, 0, 0, 0, 0, 0, 0], 
                    [0, 0, 0, 7, 7, 7, 7, 0, 0, 0], 
                    [0, 0, 0, 7, 0, 0, 7, 0, 0, 0], 
                    [0, 0, 0, 7, 0, 0, 7, 0, 0, 0], 
                    [0, 0, 0, 0, 0, 0, 0, 0, 0, 0]]
        },
        {
            "name": "3",
            "data": [[0, 0, 0, 0, 0, 0, 0, 0, 0, 0], 
                    [0, 0, 0, 0, 0, 0, 0, 0, 0, 0], 
                    [0, 0, 0, 0, 0, 0, 0, 0, 0, 0], 
                    [0, 0, 0, 0, 0, 0, 0, 0, 0, 0], 
                    [0, 0, 0, 0, 0, 0, 0, 0, 0, 0]]
        },
        {
            "name": "4",
            "data": [[0, 0, 0, 0, 0, 0, 0, 0, 0, 0], 
                    [0, 0, 0, 0, 0, 0, 0, 0, 0, 0], 
                    [0, 0, 0, 0, 0, 0, 0, 0, 0, 0], 
                    [0, 0, 0, 0, 0, 0, 0, 0, 0, 0], 
                    [0, 0, 0, 0, 0, 0, 0, 0, 0, 0]]
        },
        {
            "name": "5",
            "data": [[0, 0, 0, 0, 0, 0, 0, 0, 0, 0], 
                    [0, 0, 0, 0, 0, 0, 0, 0, 0, 0], 
                    [0, 0, 0, 0, 0, 0, 0, 0, 0, 0], 
                    [0, 0, 0, 0, 0, 0, 0, 0, 0, 0], 
                    [0, 0, 0, 0, 0, 0, 0, 0, 0, 0]]
        },
        {
            "name": "6",
            "data": [[0, 0, 0, 0, 0, 0, 0, 0, 0, 0], 
                    [0, 0, 0, 0, 0, 0, 0, 0, 0, 0], 
                    [0, 0, 0, 0, 0, 0, 0, 0, 0, 0], 
                    [0, 0, 0, 0, 0, 0, 0, 0, 0, 0], 
                    [0, 0, 0, 0, 0, 0, 0, 0, 0, 0]]
        },
        {
            "name": "collision",
            "data": [[0, 0, 0, 0, 0, 0, 0, 0, 0, 0], 
                    [0, 0, 0, 0, 0, 0, 0, 0, 0, 0], 
                    [0, 0, 0, 0, 0, 0, 0, 0, 0, 0], 
                    [0, 0, 0, 0, 0, 0, 0, 0, 0, 0], 
                    [0, 0, 0, 0, 0, 0, 0, 0, 0, 0]]
        }
    ]
}